                                                                                                                                                                  2222222222222222
                                                                                                                                                               2222222222222222222
                                                                                                                                                                2222222222222222222
 22                                                                                           333                                                             222222777777222222222
                                                                                                                                                             2222272222722227772222
                                                                                                                                                            28777727777222777777777
                                                                                                                                                           287777777222277777777777
                                                                                                                                                          2222222222222222222222222
                                                                                                        
                                                                                                       
P
33333333333333333333333333333333333333333333333333333333333333333333333333333333333333333333333333333333333333333333333333333333333333333333333333333333333333333333333333333333333
44444444444444444444444444444444444444444444444444444444444444444444444444444444444444444444444444444444444444444444444444444444444444444444444444444444444444444444444444444444444